13 13 0 0 0 0 0 0 13 13 13 13 13 13 13 13 13 13 13 13 13 13 13 13 13 13 13 13 13 13 13 13 13 13 13 13 13 13 13 13 13 13 13 13 13 13 13 13 13 13 13 13 13 13 21 21 21 21 13 13 13 13 13 13 13 13 13 13 13 13 13 13 13 13 13 13 13 13 13 21 21 21 21 13 13 13 13 13 13 13 13 13 13 13 13 13 21 21 21 21 21 21 13 13 13 13 13 13 13 13 13 13 13 13 13 13 13 13 13 13 13 13 13 13 13 13 21 21 13 21 21 21 21 21 21 13 13 13 13 13 13 13 13 13 13 13 13 13 13 21 21 13 13 13 13 13 13 13 13 13 13 13 13 13 13 13 13 13 13 13 13 18 18 18 21 21 21 21 21 21 21 21 21 13 13 13 13 13 13 13 13 13 13 13 13 18 18 18 18 18 18 18 18 18 18 18 18 13 13 13 13 13 21 21 18 18 18 18 18 18 18 18 18 18 18 18 18 18 18 18 18 18 18 18 18 18 18 18 18 18 13 13 13 13 30 31 13 13 13 13 
13 13 0 0 0 0 0 0 13 13 13 13 13 13 13 13 21 21 21 21 21 21 21 13 13 13 13 13 13 13 13 13 13 13 13 13 13 13 13 18 18 18 13 13 13 13 13 13 21 21 21 21 21 21 13 13 13 21 21 21 21 13 13 13 13 13 13 13 13 13 13 13 13 13 13 21 21 21 21 21 13 13 21 21 13 13 13 13 13 13 13 13 13 13 13 13 21 21 21 21 21 21 21 21 21 21 21 21 21 21 21 21 21 21 13 18 18 18 18 18 18 13 21 21 21 21 21 21 21 13 13 13 13 21 21 13 13 13 13 13 13 21 21 21 21 21 21 21 21 21 21 21 21 21 21 21 21 13 13 13 13 13 13 13 13 21 21 21 21 18 18 18 21 18 18 21 21 21 21 21 21 21 21 21 21 21 21 13 13 13 13 13 13 13 13 13 18 18 18 18 18 21 21 13 13 18 18 13 21 21 21 21 21 13 13 13 18 21 18 18 18 18 18 18 18 18 21 21 21 21 18 18 18 18 18 18 18 18 18 18 18 18 13 13 30 31 13 13 13 13 
13 13 0 0 0 0 0 0 13 13 13 13 13 13 13 13 13 21 13 21 21 21 21 21 21 21 21 18 18 18 21 21 21 21 21 21 13 18 18 18 13 18 13 13 13 21 21 21 21 21 21 21 21 13 13 13 13 13 13 13 13 21 21 13 13 13 13 13 13 13 13 13 21 21 21 21 13 13 13 13 13 13 13 21 21 21 21 21 13 18 18 18 18 18 18 18 18 18 18 18 18 18 18 21 21 21 13 13 13 13 13 13 13 21 18 18 21 21 18 18 18 18 18 18 21 21 21 13 13 13 13 13 13 21 18 21 21 21 21 21 21 21 13 13 13 13 13 21 21 21 21 13 13 21 21 21 13 21 21 21 21 21 21 21 21 13 18 18 18 21 18 18 18 18 18 21 21 21 21 13 21 21 21 21 21 21 21 21 21 21 21 21 21 21 21 21 18 18 18 18 18 18 18 18 18 18 21 21 21 13 13 13 13 13 21 21 18 18 18 18 18 18 18 18 18 21 21 13 13 18 18 18 21 18 18 18 18 18 18 18 18 13 13 13 30 31 13 21 13 13 
13 13 0 0 0 0 0 0 13 13 13 13 13 21 21 13 13 21 21 13 13 21 21 21 18 18 18 18 13 18 18 21 21 13 18 18 18 13 13 13 13 13 21 21 21 21 13 13 13 13 13 13 13 13 13 13 13 13 13 13 13 13 21 21 21 21 21 21 21 21 21 21 21 21 21 21 13 13 13 13 13 13 13 13 13 21 21 21 21 21 18 18 21 21 21 13 13 13 21 21 21 21 18 18 18 18 21 21 21 21 13 13 13 13 13 21 21 21 21 21 21 18 18 18 18 18 18 18 21 13 13 13 21 21 18 21 13 13 18 18 18 21 21 21 21 21 21 13 13 13 13 21 21 21 21 21 21 18 18 18 18 18 18 18 18 18 18 18 18 18 18 21 18 13 18 21 21 21 21 21 21 21 21 21 21 21 21 21 21 21 21 13 13 18 18 18 18 18 18 21 18 18 18 18 18 18 21 21 21 21 21 21 21 21 21 21 21 21 21 13 13 13 13 13 13 13 13 13 13 21 13 13 21 21 13 13 21 18 18 18 18 21 13 13 30 31 21 21 21 13 
13 13 0 0 0 0 0 0 13 13 13 21 13 21 21 21 13 13 21 21 21 21 21 18 18 13 21 21 21 21 18 18 18 18 18 13 13 13 13 13 21 21 21 21 21 21 21 21 13 13 13 13 13 13 13 21 13 13 13 13 13 13 13 21 21 21 21 21 21 21 13 18 18 18 18 18 18 13 13 13 21 21 21 21 21 21 13 13 13 13 13 18 21 13 13 13 21 21 21 13 13 21 18 18 18 18 21 21 21 21 21 21 21 21 21 21 21 21 21 21 21 21 21 18 18 18 18 18 18 18 18 18 18 21 18 13 13 13 18 18 13 21 21 21 21 13 13 21 21 21 21 21 21 21 21 18 18 18 13 13 13 13 13 13 13 18 18 18 18 13 21 13 21 21 18 18 21 21 21 13 21 21 21 21 13 13 13 13 13 21 21 21 21 21 21 21 21 21 18 18 18 18 18 21 21 21 21 21 21 21 21 21 21 21 21 13 21 21 21 21 21 13 13 13 13 13 21 21 21 21 13 13 13 21 21 13 21 18 18 21 18 21 13 13 30 31 21 13 21 13 
13 13 0 0 0 0 0 0 13 13 13 21 13 13 21 21 21 13 13 13 18 13 21 18 13 13 13 13 13 13 13 13 13 13 21 21 21 21 21 21 21 21 21 13 21 21 21 21 13 13 13 13 13 13 21 21 13 13 13 13 13 13 18 18 18 18 21 21 13 13 13 18 13 13 13 13 18 18 21 21 21 21 13 21 21 21 21 21 21 21 21 21 21 21 13 21 21 13 13 18 13 18 18 18 18 18 18 18 13 13 13 21 21 13 21 21 21 21 13 13 13 21 21 21 21 21 21 21 13 13 21 21 21 21 18 13 21 13 18 18 18 18 18 18 18 18 21 21 21 21 21 21 21 21 21 13 21 21 21 21 21 21 21 21 21 21 21 18 18 18 18 18 18 18 18 18 18 13 21 21 21 13 21 21 21 21 21 21 21 21 21 21 21 21 21 21 21 13 13 21 13 21 21 21 21 21 21 21 21 21 21 21 13 13 13 13 13 13 13 21 21 21 21 21 21 21 13 13 13 13 13 21 13 13 21 21 21 18 18 18 18 13 13 13 30 31 21 13 21 13 
13 13 0 0 0 0 0 0 13 13 13 21 21 21 21 21 13 21 21 13 13 18 18 18 21 21 13 13 13 13 13 13 13 21 21 21 21 21 13 13 13 13 13 13 21 21 21 21 21 18 18 18 18 18 18 18 18 18 18 18 18 18 18 13 13 21 21 13 13 13 13 13 13 13 21 21 21 18 18 21 21 13 13 18 18 18 21 18 18 21 13 13 13 21 21 21 13 13 18 18 18 18 18 18 18 18 13 18 18 18 18 18 18 18 18 13 13 13 13 13 13 21 21 21 21 21 21 21 18 18 21 21 21 13 18 21 21 21 21 18 18 18 13 13 13 21 21 21 21 21 21 21 13 13 21 21 21 21 21 21 21 13 13 21 21 21 13 13 13 13 13 13 13 18 18 13 13 13 13 13 13 13 13 13 13 13 13 13 13 21 21 21 21 21 21 13 13 13 13 21 21 21 21 21 21 21 21 21 13 13 21 21 13 13 13 13 13 13 21 21 13 13 13 21 21 13 13 13 13 13 21 21 13 13 21 21 21 18 18 18 13 13 13 13 30 31 21 13 21 13 
21 18 0 0 0 0 0 0 13 13 13 21 13 13 13 21 21 21 13 13 13 18 18 13 13 21 21 21 21 21 13 13 13 13 13 13 13 13 13 13 13 13 13 13 13 13 21 21 21 21 21 21 13 13 13 13 13 13 13 13 13 13 13 13 13 13 21 21 13 13 13 13 21 21 21 13 13 13 18 18 18 18 18 18 13 13 13 18 18 18 18 18 21 13 13 13 13 13 13 13 13 13 13 13 13 13 13 13 13 21 21 21 13 13 21 21 21 21 21 21 21 13 13 18 18 18 18 18 18 13 13 13 13 13 18 13 13 13 13 21 18 18 18 18 21 13 13 13 13 13 13 13 13 13 13 13 13 13 13 13 21 21 21 21 13 13 13 13 13 13 13 13 13 13 13 13 13 13 13 13 21 13 13 13 21 21 18 21 21 21 21 21 13 13 13 13 13 13 13 13 13 13 13 13 13 13 13 13 13 13 21 13 13 13 13 13 21 21 21 21 13 13 13 13 13 13 13 13 13 13 13 21 21 13 21 21 13 13 21 13 13 13 13 13 30 31 21 13 21 13 
18 18 0 0 0 0 0 0 13 13 13 13 13 13 13 13 13 13 13 13 13 13 13 13 13 13 13 13 13 13 13 13 13 13 13 13 13 13 13 13 13 13 13 13 13 13 13 13 13 13 13 13 13 13 13 13 13 13 13 13 13 13 13 13 13 13 13 13 13 21 21 21 21 13 13 13 13 18 18 13 13 13 13 13 13 13 18 18 18 18 18 18 18 18 13 13 13 13 13 13 13 13 13 13 13 13 13 13 13 13 13 13 13 13 13 13 13 13 13 13 18 18 18 18 13 13 13 13 13 13 13 13 18 18 18 18 13 13 13 13 13 13 18 18 13 13 13 13 13 13 13 13 13 13 13 13 13 13 13 13 13 13 13 13 13 13 13 13 13 13 13 21 13 13 13 13 13 13 13 13 21 21 21 21 18 18 18 18 13 13 13 13 13 13 13 13 13 13 13 13 13 13 13 13 13 13 13 13 13 13 21 21 21 13 13 21 21 13 13 13 13 13 13 13 13 13 13 13 13 13 13 21 21 21 21 21 13 13 21 13 13 13 13 13 30 31 21 13 21 13 
18 13 0 0 0 0 0 0 0 0 0 0 0 0 13 13 13 13 13 13 0 0 0 0 0 0 0 0 0 0 0 0 0 2 2 0 0 0 0 0 0 2 2 2 0 0 0 0 0 0 0 0 0 0 0 2 2 0 0 13 13 13 0 0 0 0 0 13 13 0 0 0 0 0 0 0 0 18 18 18 0 0 0 0 0 0 0 18 18 18 18 18 18 18 0 0 0 0 13 13 13 0 0 0 0 0 0 0 0 0 0 0 0 0 0 0 0 0 0 0 0 0 0 0 0 0 0 0 0 0 0 0 18 18 18 18 0 0 0 0 0 0 18 0 0 0 0 0 13 13 2 2 2 2 2 2 13 2 2 2 2 2 2 13 2 2 2 2 2 2 21 21 21 21 21 21 21 21 21 0 0 0 0 0 18 18 18 18 0 0 0 0 0 0 2 2 2 2 2 2 2 2 2 2 0 0 0 0 0 0 0 0 13 13 13 13 0 0 0 0 0 0 0 0 0 13 13 13 13 13 13 21 21 21 21 21 13 13 21 13 13 13 13 13 30 31 21 13 21 13 
18 13 0 0 0 0 0 0 0 0 0 0 0 0 0 0 0 13 13 13 21 21 21 21 13 13 13 0 0 0 0 0 0 0 0 0 0 0 0 0 0 0 0 0 0 0 0 0 0 0 0 0 0 0 0 0 0 0 0 13 13 13 0 0 0 0 0 0 0 0 0 0 0 0 0 0 0 18 18 18 0 0 0 0 0 0 0 18 18 18 0 0 0 0 0 0 0 0 0 0 0 0 0 0 0 0 0 0 0 0 0 0 0 0 0 0 0 0 0 0 0 0 0 0 0 0 0 0 0 0 0 0 0 18 18 0 0 0 0 0 0 0 0 0 0 0 0 0 13 13 0 0 0 0 0 0 13 0 0 0 0 0 2 2 2 0 0 0 0 0 21 21 21 21 21 21 21 21 0 0 0 0 0 0 0 0 0 0 0 0 0 0 0 0 0 0 0 0 0 0 0 0 0 0 0 0 0 0 0 0 0 0 13 13 13 0 0 0 0 0 0 0 0 0 0 0 13 13 13 13 13 21 21 21 21 21 13 21 21 13 13 13 13 13 30 31 21 21 21 21 
21 13 0 0 0 0 0 0 0 0 0 0 0 0 0 0 0 0 0 0 21 21 13 21 13 13 13 13 13 0 21 0 0 0 0 0 0 0 0 0 0 0 0 0 0 0 0 0 0 0 0 0 0 0 0 0 0 0 13 13 0 0 0 0 0 0 0 0 0 0 0 0 0 0 0 0 0 0 18 0 0 0 0 0 0 0 0 0 18 18 0 0 0 0 0 0 0 0 0 0 0 0 0 0 0 0 0 0 0 0 0 0 0 0 0 0 0 0 0 0 0 0 0 0 0 0 0 0 0 0 0 0 0 18 18 0 0 0 0 0 0 0 0 0 0 0 0 0 13 13 0 0 0 0 0 0 13 0 0 0 0 0 0 0 0 0 0 0 0 0 13 13 21 21 13 13 13 13 0 0 0 0 0 0 0 0 0 0 0 0 0 0 0 0 0 0 0 0 0 0 0 0 0 0 0 0 0 0 0 0 0 0 13 13 13 0 0 0 0 0 0 0 0 0 0 0 13 13 13 13 13 13 21 13 21 21 21 21 13 13 13 13 13 13 30 31 13 21 13 21 
21 13 0 0 0 0 0 0 0 0 0 0 0 0 0 0 0 0 0 0 0 0 0 0 0 0 0 13 13 13 21 21 21 13 13 13 0 0 0 0 0 0 0 0 0 0 0 0 0 0 0 0 0 0 0 0 0 13 13 0 0 0 0 0 0 0 0 0 0 0 0 0 0 0 0 0 0 0 0 0 0 0 0 0 0 0 0 0 0 0 0 0 0 0 0 0 0 0 0 0 0 0 0 0 0 0 0 13 13 13 13 13 13 13 13 0 0 0 0 0 0 0 0 0 0 0 0 0 0 0 0 0 0 0 0 0 0 0 0 0 0 0 0 0 0 0 0 0 13 13 0 0 0 0 0 0 13 13 0 0 0 0 0 0 0 0 0 0 0 0 0 13 13 13 13 13 13 2 0 0 0 0 0 0 0 0 0 0 0 0 0 0 0 0 0 0 0 0 0 0 0 0 0 0 0 0 0 0 0 0 0 0 0 13 0 0 0 0 0 0 0 0 0 0 0 0 0 13 13 13 21 21 21 21 21 21 13 21 13 13 13 13 13 13 30 31 13 21 13 21 
21 21 0 0 0 0 0 0 0 0 0 0 0 0 0 0 0 0 0 0 0 0 0 0 0 0 0 0 0 0 0 21 21 13 13 13 13 13 21 21 21 21 13 13 13 0 0 0 0 0 0 0 0 0 0 0 0 13 13 0 0 0 0 0 0 0 0 0 0 0 0 0 0 0 0 0 0 0 0 0 0 0 0 0 0 0 0 0 0 0 0 0 0 0 0 0 0 0 0 0 0 13 13 21 21 21 21 21 0 0 0 0 2 2 13 21 21 13 13 13 13 13 13 0 0 0 0 0 0 0 0 0 0 0 0 0 0 0 0 0 0 0 0 0 0 0 0 0 13 13 13 13 0 0 0 0 13 0 0 0 0 0 0 0 0 0 0 0 0 0 0 0 13 13 13 13 2 0 0 0 0 0 0 0 0 0 0 0 0 0 13 13 13 13 13 13 21 21 21 21 21 13 13 13 13 13 0 0 0 0 0 0 0 0 0 0 0 0 0 0 0 0 0 0 0 0 0 2 13 13 21 21 21 21 21 21 21 21 21 13 13 13 13 13 30 31 13 21 13 21 
13 21 0 0 0 0 0 0 0 0 0 0 0 0 0 0 0 0 0 0 0 0 0 0 0 0 0 0 0 0 0 0 0 0 0 0 0 13 13 21 21 21 13 13 13 13 0 0 0 0 0 0 0 0 0 0 21 13 0 0 0 0 0 0 0 0 0 0 0 0 0 0 0 0 0 0 0 0 0 0 0 0 0 0 0 0 0 0 0 0 0 0 0 0 0 0 0 13 13 13 21 13 0 0 0 2 2 2 0 0 0 0 0 0 0 0 0 0 0 2 2 2 13 13 13 13 13 13 0 0 0 0 0 0 0 0 0 0 0 0 0 0 0 0 0 0 0 0 13 13 13 0 0 0 0 0 13 0 0 0 0 0 21 21 21 21 21 0 0 0 0 0 0 13 13 13 0 0 0 0 0 0 0 0 0 0 0 0 0 13 13 0 0 0 0 0 0 0 0 0 0 2 2 13 13 13 0 0 0 0 0 0 0 0 0 0 0 0 0 0 2 2 0 0 0 0 0 0 2 2 21 21 21 21 21 21 21 13 21 21 13 13 13 13 30 31 13 21 13 21 
13 21 0 0 0 0 0 0 0 0 0 0 0 0 0 0 0 0 0 0 0 0 0 0 0 0 0 0 0 0 0 0 0 0 0 0 0 0 0 0 0 0 0 0 0 0 0 0 0 0 0 0 0 0 0 13 21 0 0 0 0 0 0 0 0 0 0 0 0 0 0 0 0 0 0 0 0 0 0 0 0 0 0 0 0 0 0 0 0 0 0 0 0 0 21 21 13 13 0 0 0 0 0 0 0 0 0 0 0 0 0 0 0 0 0 0 0 0 0 0 0 0 0 0 0 0 0 13 0 0 0 0 0 0 0 0 0 0 0 0 0 0 0 0 0 0 0 0 13 0 0 0 0 0 0 0 0 0 0 0 13 21 21 21 21 21 21 13 13 13 0 21 21 13 21 21 0 0 0 0 0 0 0 0 13 13 13 0 0 0 0 0 0 0 0 0 0 0 0 0 0 0 0 0 13 13 13 0 0 0 0 0 0 0 0 0 0 0 0 0 0 0 0 0 0 0 0 0 0 0 21 21 21 13 21 21 21 13 13 21 21 13 13 13 30 31 13 21 13 21 
13 21 0 0 0 0 0 0 0 0 0 0 0 0 0 0 0 0 0 0 0 0 0 0 0 0 0 0 0 0 0 0 0 0 0 0 0 0 0 0 0 0 0 0 0 0 0 0 0 0 0 0 0 0 0 13 0 0 0 0 0 0 0 0 0 0 0 0 0 0 0 0 0 0 0 0 0 0 0 0 0 0 0 0 0 0 0 0 0 0 0 0 0 13 21 2 2 0 0 0 0 0 0 0 0 0 0 0 0 0 0 0 0 0 0 0 0 0 0 0 0 0 0 0 0 0 13 21 0 0 0 0 0 0 0 0 0 0 0 0 0 0 0 0 0 0 0 0 13 0 0 0 13 13 13 13 21 13 21 21 21 21 21 21 21 21 21 13 13 13 13 21 21 21 21 21 0 0 0 0 13 13 13 13 13 13 13 13 21 21 21 21 0 0 0 0 0 0 0 0 0 0 0 0 13 13 13 13 13 0 0 0 0 0 0 0 0 0 0 0 0 0 0 0 0 0 0 0 0 0 21 21 13 21 21 21 21 13 13 13 21 21 13 13 30 31 13 21 13 21 
13 21 0 0 0 0 0 0 0 0 0 0 0 0 0 0 0 0 0 0 0 0 0 0 0 0 0 0 0 0 0 0 0 0 0 0 0 0 0 0 0 0 0 0 0 0 0 0 0 0 0 0 0 0 13 13 0 0 0 0 0 0 0 0 0 0 0 0 0 0 0 0 0 0 0 0 0 0 0 0 0 0 0 0 0 0 0 0 0 0 0 0 13 13 0 0 0 0 0 0 0 0 0 0 0 0 0 0 0 0 0 0 0 0 0 0 0 0 0 0 0 0 13 13 13 13 21 21 21 0 0 0 0 0 0 0 0 0 0 0 0 0 0 0 0 0 0 0 0 0 13 13 13 13 13 21 21 18 18 18 21 21 21 21 21 21 21 21 13 13 13 13 13 21 21 21 13 13 13 13 13 13 13 13 13 13 13 13 13 0 13 13 0 0 0 0 0 0 0 0 0 0 0 0 0 13 13 13 13 13 0 0 0 0 0 0 13 13 21 21 21 21 21 0 0 0 13 13 13 13 21 21 21 21 21 21 21 13 13 13 13 21 21 13 30 31 13 21 21 21 
13 21 0 0 0 0 0 0 0 0 0 0 0 0 0 0 0 0 0 0 0 0 0 0 0 0 0 0 0 0 0 0 0 0 0 0 0 0 0 0 0 0 0 0 0 0 0 0 0 0 0 21 21 13 13 0 0 0 0 0 0 0 0 0 0 0 0 0 0 0 0 0 0 0 0 0 0 0 0 0 0 0 0 0 0 0 0 0 0 0 0 0 0 0 0 0 0 0 0 0 0 0 0 0 0 0 0 0 0 0 0 0 0 0 13 13 13 13 13 13 13 13 13 13 13 21 21 13 21 0 0 0 0 0 0 0 0 0 0 0 0 0 0 0 0 0 0 13 13 13 13 13 13 21 21 21 18 18 18 18 18 18 18 18 18 18 18 18 18 13 13 13 13 21 21 21 13 13 13 13 13 13 13 13 13 21 21 13 0 0 0 0 0 0 0 0 0 0 0 0 0 0 0 0 0 0 0 13 13 13 0 0 0 0 0 0 0 0 13 21 21 21 21 21 21 13 13 13 13 13 13 21 21 13 21 21 21 13 13 13 13 21 21 13 30 31 13 13 21 21 
13 13 0 0 0 0 0 0 0 0 0 0 0 0 0 0 0 0 0 0 0 0 0 0 0 0 0 0 0 0 0 0 0 0 0 0 0 0 0 0 0 0 0 0 0 0 0 0 0 0 13 21 13 13 0 0 0 0 0 0 0 0 0 0 0 0 0 0 0 0 0 0 0 0 0 0 0 0 0 0 0 0 0 0 0 0 0 0 0 0 0 0 0 0 0 0 0 0 0 0 0 0 0 0 0 0 0 0 0 21 21 21 13 13 13 13 0 0 0 0 0 0 13 13 13 21 13 13 21 0 0 0 0 0 0 0 0 0 0 0 0 0 0 0 0 0 0 13 13 13 13 13 21 21 21 18 18 18 18 18 18 18 18 18 18 18 18 18 18 18 18 18 13 13 13 21 13 13 13 13 21 21 13 13 13 21 13 0 0 0 0 0 0 0 0 0 0 0 0 13 0 0 0 0 0 0 0 21 21 13 0 0 0 0 0 0 0 0 0 0 0 0 0 0 0 0 0 0 0 0 0 21 21 21 13 21 13 13 13 13 13 21 13 13 30 31 13 13 21 21 
13 13 0 0 0 0 0 0 0 0 0 0 0 0 0 0 0 0 0 0 0 0 0 0 0 0 0 0 0 13 13 13 13 13 13 0 0 0 0 0 0 0 0 0 0 0 0 13 13 13 13 13 0 0 0 0 0 0 0 0 0 0 0 0 0 0 0 0 0 0 0 0 0 0 0 0 0 0 0 0 0 0 0 0 0 0 0 0 0 0 0 0 0 0 0 0 0 0 0 0 0 13 21 21 13 13 13 13 13 21 21 13 13 13 13 0 0 0 0 0 0 0 21 13 21 21 13 13 21 0 0 0 0 0 0 0 0 0 0 0 0 0 0 0 0 0 13 13 13 13 13 13 13 21 21 18 18 18 18 18 18 18 18 18 18 18 18 18 18 18 18 18 18 18 21 21 13 13 13 13 13 21 21 13 21 21 0 0 0 0 0 0 0 0 0 0 0 13 13 13 0 0 0 0 0 0 0 0 21 21 21 0 0 0 0 0 0 0 0 0 0 0 0 0 0 0 0 0 0 0 0 0 0 21 21 21 13 13 13 13 13 21 13 13 30 31 13 13 21 21 
13 13 0 0 0 0 0 0 0 0 0 0 0 2 2 2 0 0 0 0 0 0 0 0 0 0 13 13 13 13 18 18 18 18 13 13 13 13 13 13 0 0 0 0 0 0 0 0 0 0 0 0 0 0 0 0 0 0 0 0 0 0 0 0 0 0 0 0 0 0 0 0 0 0 0 0 0 0 0 0 0 0 0 0 0 0 0 0 0 0 0 21 21 21 13 13 13 13 13 13 13 13 21 21 13 13 0 0 13 13 13 13 0 0 0 0 0 0 0 0 0 0 21 13 21 13 13 13 13 0 0 0 0 0 0 0 0 0 0 0 0 0 0 0 0 0 13 13 13 13 13 21 21 21 21 18 18 18 18 18 18 18 18 18 18 18 18 18 18 18 18 13 18 18 13 13 13 13 13 13 21 21 21 13 0 0 0 0 0 0 0 0 0 0 0 0 21 21 0 0 0 0 0 0 0 0 0 0 21 21 21 0 0 0 0 0 0 0 0 0 0 0 0 0 0 0 0 0 0 0 0 0 0 0 13 21 21 21 13 13 13 21 21 13 30 31 13 13 21 13 
13 13 0 0 0 0 0 0 0 0 0 0 0 0 0 0 0 0 0 0 0 0 0 0 13 13 13 13 13 13 13 18 18 18 18 13 13 13 13 13 13 0 0 0 0 0 0 0 0 0 0 0 0 0 0 0 0 0 0 0 0 0 0 0 0 0 13 13 13 0 0 0 0 0 0 0 13 13 13 13 0 0 0 0 0 0 0 0 0 0 0 0 0 0 0 0 0 0 0 0 0 0 0 0 0 0 0 0 0 0 0 0 0 0 0 0 0 0 0 0 0 0 0 13 21 21 21 13 21 13 0 0 0 0 0 0 0 0 0 0 0 0 0 0 0 0 13 13 13 13 13 13 13 21 13 21 21 21 13 13 13 13 21 13 18 18 18 18 18 18 18 18 18 18 13 13 13 13 13 13 21 21 21 0 0 0 0 0 0 0 0 0 0 0 0 13 13 0 0 0 0 0 0 0 0 0 0 0 21 21 21 13 0 0 0 0 0 0 0 0 0 0 0 0 0 0 0 0 0 0 0 0 0 0 0 13 13 21 21 21 21 13 21 21 30 31 13 13 21 13 
13 21 0 0 0 0 0 0 0 0 0 0 0 0 0 0 0 0 0 0 0 0 13 13 13 21 21 13 21 21 21 21 21 21 13 13 13 21 13 13 13 13 0 0 0 0 0 0 0 0 0 0 0 0 0 0 0 0 0 0 0 0 0 13 13 13 13 2 2 13 13 13 13 13 13 13 13 13 2 13 13 13 13 13 13 13 13 13 0 0 0 0 0 0 0 0 0 0 0 0 0 0 0 0 0 0 0 0 0 0 0 0 0 0 0 0 0 0 0 0 0 0 0 13 13 13 13 13 21 13 0 0 0 0 0 0 0 0 0 0 0 0 0 0 0 0 13 13 13 13 13 13 13 21 21 21 21 13 13 13 13 13 13 13 13 13 13 13 13 13 13 13 13 13 13 13 13 13 13 0 0 0 0 0 0 0 0 0 0 0 0 0 0 13 13 13 2 0 0 0 0 0 0 0 0 0 0 0 0 13 13 13 0 0 0 0 0 0 0 0 0 0 0 0 0 0 0 0 0 0 0 0 0 0 0 0 13 13 13 13 21 21 21 21 30 31 13 13 21 13 
21 21 0 0 0 0 0 0 0 0 0 0 0 0 0 0 0 0 0 0 0 13 13 13 13 21 21 21 21 21 13 13 13 13 13 13 13 21 13 13 13 13 13 0 0 0 0 0 0 0 0 0 0 0 0 0 0 0 0 0 0 0 0 0 0 2 2 0 0 0 0 0 0 0 0 0 0 0 0 0 0 0 0 0 0 13 18 18 13 13 0 0 0 0 0 0 0 0 0 0 0 0 0 0 0 0 0 0 0 0 0 0 2 2 0 0 0 0 0 0 0 0 0 0 13 13 21 21 13 13 13 0 0 0 0 0 0 0 0 0 0 0 0 0 0 0 0 0 0 13 13 13 13 13 13 13 13 13 13 13 13 13 13 13 13 13 13 13 13 13 13 13 13 13 0 0 0 0 0 0 0 0 0 0 0 0 0 0 0 0 0 0 21 13 2 2 0 0 0 0 0 0 0 0 0 0 0 0 0 0 13 13 13 13 13 0 0 0 0 0 0 0 0 0 0 0 0 0 0 0 0 0 0 0 0 0 0 0 13 13 13 13 13 13 30 31 13 13 21 13 
21 13 0 0 0 0 0 0 0 0 0 0 0 0 0 0 0 0 0 13 13 13 13 13 13 21 21 21 13 21 13 13 13 13 13 21 21 21 21 21 21 13 13 13 13 13 13 13 0 0 0 0 0 0 0 0 13 13 13 0 0 0 0 0 0 0 0 0 0 0 0 0 0 0 0 0 0 0 0 0 0 0 0 13 13 13 13 13 13 13 13 13 0 0 0 0 0 0 0 0 0 0 0 0 0 0 0 0 0 0 0 0 0 0 0 0 0 0 0 0 0 0 0 0 13 13 21 21 21 13 13 13 0 0 0 0 0 0 0 0 0 0 0 0 0 0 0 0 0 0 13 13 13 13 13 13 13 13 0 0 0 0 0 13 13 13 13 13 13 13 0 0 0 0 0 0 0 0 0 0 0 0 0 0 0 0 0 0 0 0 0 0 21 2 0 0 0 0 0 0 0 0 0 0 0 0 0 0 0 0 0 13 13 13 13 13 13 13 0 0 0 0 0 0 0 0 0 0 0 0 0 0 0 0 0 0 0 0 0 13 13 13 13 13 30 31 13 13 21 13 
21 13 0 0 0 0 0 0 0 0 0 0 0 0 0 0 0 0 13 13 13 13 13 13 21 21 21 13 21 21 13 18 18 13 21 13 21 21 21 21 21 13 13 13 13 13 13 13 13 13 0 0 0 0 13 13 13 13 0 0 0 0 0 0 0 0 0 0 0 0 0 0 0 0 0 0 0 0 0 0 0 0 13 13 13 13 13 13 13 13 13 13 0 0 0 0 0 0 0 2 2 2 0 0 0 0 0 0 0 0 0 0 0 0 0 0 0 0 0 2 2 0 0 0 0 13 13 21 21 13 13 13 13 0 0 0 0 0 0 0 0 0 0 0 0 0 0 0 0 0 0 0 0 0 0 0 0 0 0 0 0 0 0 0 0 0 0 0 0 0 0 0 0 0 0 0 0 0 0 0 0 0 0 0 0 0 0 0 0 13 13 21 21 0 0 0 0 0 0 0 0 0 0 0 0 0 0 0 0 0 0 0 2 2 2 13 13 13 13 13 13 21 13 21 13 13 13 13 13 13 13 13 0 0 0 0 0 0 0 0 13 13 13 13 30 31 13 13 21 13 
21 13 0 0 0 0 0 0 0 0 0 0 0 0 0 0 0 13 13 13 18 13 13 21 21 21 21 21 21 18 18 18 13 13 21 21 13 21 13 13 21 21 13 13 13 13 13 13 13 13 13 0 0 13 13 13 13 0 0 0 0 0 0 0 0 0 0 0 0 0 0 0 0 0 0 0 0 0 0 0 13 13 13 13 13 21 21 21 21 21 13 13 13 0 0 0 0 0 0 0 0 0 0 0 0 0 0 0 0 0 0 0 0 0 0 0 0 0 0 0 0 0 0 0 0 13 13 13 21 13 13 13 13 13 13 0 0 0 0 0 0 0 0 0 0 0 0 0 0 0 0 0 0 0 0 0 0 0 0 0 0 0 0 0 0 0 0 0 0 0 0 0 0 0 0 0 0 0 0 0 0 0 0 0 0 0 0 13 13 13 13 13 0 0 0 0 0 0 0 0 0 0 0 0 0 0 0 0 0 0 0 0 0 0 0 0 0 0 0 13 21 21 21 21 13 0 0 0 0 0 0 13 0 0 0 0 0 0 0 10 33 33 33 33 11 31 13 13 21 13 
13 13 0 0 0 0 0 0 0 0 0 0 0 0 13 13 13 13 13 13 18 18 13 13 13 13 13 13 13 13 13 13 13 13 13 21 21 21 13 13 13 13 13 13 13 13 13 13 13 13 13 18 18 13 13 13 13 0 0 0 0 0 0 0 0 0 0 0 0 0 0 0 0 13 13 13 13 13 13 13 13 13 13 13 13 21 13 21 21 13 13 13 13 0 0 0 0 0 0 0 0 0 0 0 0 0 0 0 0 0 0 0 0 0 0 0 0 0 0 0 0 0 0 0 0 0 13 13 13 13 13 13 13 13 13 0 0 0 0 0 0 0 0 0 0 0 0 0 0 0 0 0 0 0 0 0 0 0 0 0 0 0 0 0 0 0 0 0 0 0 0 0 0 0 0 0 0 0 0 0 0 0 0 0 0 0 13 13 13 0 0 0 0 0 0 0 0 0 0 0 0 0 0 0 0 0 0 0 0 0 0 0 0 0 0 0 0 0 0 0 0 0 0 0 0 0 0 0 0 0 13 13 21 0 0 0 0 0 0 32 34 34 34 34 35 31 13 13 21 13 
13 13 13 13 13 13 13 13 13 13 13 18 18 13 13 13 13 13 13 18 18 13 13 13 13 13 13 13 13 13 13 13 13 13 13 13 21 13 13 13 13 13 13 13 13 13 13 13 13 21 21 21 18 18 18 18 13 13 13 13 13 13 13 13 13 13 13 13 13 13 13 13 13 13 13 13 13 13 13 13 18 18 18 13 13 21 21 21 21 13 13 13 13 13 13 13 13 13 13 13 13 21 13 21 21 21 21 21 21 21 13 13 13 13 13 13 13 13 13 13 13 13 13 13 13 13 13 13 13 13 13 13 13 13 13 13 13 13 13 13 13 13 13 13 13 13 13 13 13 13 13 13 13 13 13 13 13 13 13 13 13 13 13 13 13 13 13 13 13 13 13 13 13 13 13 13 13 13 13 13 13 13 13 13 13 13 13 13 13 13 13 13 13 13 13 13 13 13 13 13 13 21 21 21 21 13 13 13 13 13 13 13 13 13 18 18 18 13 13 13 13 13 13 18 13 13 13 13 13 13 21 21 21 21 21 13 13 13 13 13 13 13 13 13 13 13 13 21 21 13 
13 13 13 13 18 18 18 18 18 18 18 18 13 13 13 13 13 21 21 21 21 21 13 13 13 13 21 21 21 21 21 21 21 21 21 13 21 13 13 13 13 13 13 13 13 13 21 21 21 21 21 13 13 21 21 18 21 21 21 21 21 21 21 21 21 13 13 13 13 13 13 13 13 13 13 21 13 13 13 18 18 13 13 13 13 13 13 13 21 21 13 13 13 13 13 13 13 13 21 21 21 21 21 21 13 18 18 18 13 21 21 21 21 21 21 21 21 21 21 21 21 21 21 21 21 21 21 13 13 13 13 13 13 13 13 13 13 21 21 21 21 21 13 21 21 13 13 13 13 13 13 21 21 21 13 13 21 21 21 13 13 13 13 13 13 13 13 18 18 18 18 18 18 13 21 13 13 13 13 13 13 18 18 18 18 18 21 21 21 13 13 13 13 13 18 18 13 13 21 21 21 21 21 13 21 21 21 21 13 13 13 13 13 18 18 13 18 18 18 18 18 18 18 18 21 21 21 21 13 13 13 13 21 21 13 13 13 13 13 13 13 13 13 13 13 13 13 21 13 13 
13 13 13 13 18 18 13 13 21 21 21 21 21 21 21 21 21 21 13 13 13 13 13 13 13 13 21 21 21 13 13 21 21 13 13 13 21 21 21 21 21 21 21 21 21 21 21 21 21 21 13 13 13 13 13 18 18 18 18 18 18 21 13 13 13 13 13 13 13 13 13 13 21 21 21 21 18 18 18 18 13 13 13 13 13 13 13 13 13 21 21 13 13 18 18 13 13 13 13 13 13 21 21 13 13 13 13 18 18 18 18 18 18 21 21 13 13 21 21 21 21 21 21 13 13 13 13 13 13 13 13 13 13 13 13 18 18 18 18 18 18 18 18 18 21 21 21 21 21 13 13 21 21 21 21 18 18 18 18 18 18 18 18 18 18 18 18 21 13 21 21 21 18 18 18 18 18 18 18 18 18 13 18 13 13 18 21 21 21 21 21 18 18 18 18 13 13 21 21 13 13 13 21 21 21 21 21 21 21 21 21 21 18 18 21 21 21 21 21 21 21 18 18 18 18 18 18 18 18 18 18 13 21 21 21 13 13 13 13 13 13 13 13 13 13 21 21 21 13 13 
13 13 13 13 13 13 13 13 13 13 13 13 13 13 13 13 13 13 13 13 13 13 13 13 13 13 21 21 21 21 21 21 13 13 13 13 13 13 21 21 13 13 13 13 21 21 13 13 13 13 13 13 13 13 13 13 13 21 21 13 18 21 21 13 13 13 13 13 13 13 13 13 13 18 18 18 18 21 13 13 13 13 13 13 13 13 13 13 13 13 13 13 13 13 18 18 13 13 13 13 13 21 13 13 21 13 13 13 13 13 21 13 13 13 13 13 13 13 13 13 13 13 13 13 13 13 13 13 13 13 13 13 13 13 13 13 13 21 21 21 21 21 21 18 18 18 18 18 18 18 18 18 18 18 18 18 18 21 21 13 13 21 21 21 18 18 13 21 21 13 13 13 13 13 21 21 21 21 13 13 13 13 13 13 13 18 18 18 18 18 18 18 21 13 21 21 21 13 13 13 13 13 13 13 13 21 21 21 21 21 21 13 21 21 21 21 21 21 21 21 21 13 13 18 18 18 18 18 18 18 13 13 13 13 21 21 21 21 21 21 21 21 21 21 21 21 13 13 13 13 
